20 20
********************
********************
********************
********************
********************
********************
*                  *
* ******************
* ******************
* ******************
* ******************
* ******************
********************
********************
********************
********************
********************
********************
********************
********************