20 20
********************
************* ******
*************  *****
***             ****
*************  *****
************* ******
********************
*                  *
* **************** *
* *** ************ *
* **   *********** *
* *     ********** *
* *** ************ *
* *** ************ *
* *** ************ *
* *** ************ *
* *** ************ *
* **************** *
*                  *
********************