20 20
********************
******     ** **   *
****   ******  * ***
***              ***
********** **  *****
***        **   ****
***   ********* ****
*                  *
* **  ** ********* *
* *** ***      *** *
* **   *     ***** *
* *      **    *** *
* *** *** **    ** *
***** ***** ****** *
*   *     *** **** *
* * * ** **     ** *
*     ****** *   * *
* **  *    ******* *
*                  *
********************