20 20
*                 **
 *  *    *        **
        * **        
  ** ** * *   * **
  *      ***   *  **
 *        * *  *   *
 *      *    *      
      * **  ** *   *
*  *  *   * *     *
 **    ** **
  *  *     *  *  ***
*** *  * *        **
*        *
  *  ** **         *
    *  *  *    *
   *  *   **  *   * 
*   *  *        **  
                *   
   **  *  *     **  
    *   **  *  ** *